sequences: Sequences
series: Series
divergence-tests: Divergence and integral tests
comparison-tests: Ratio, root, and comparison tests
alternating-series: Alternating series
power-series: Power series
taylor-series: Taylor series
polar-coordinates: Calculus in polar coordinates
vectors: Vectors
dot-products: Dot products
cross-products: Cross products
curves: Lines and curves in space
arc-length: Motion in space and length of curves
curvature: Curvature and normal vectors
planes: Planes, surfaces, graphs, level curves
limits: Limits
continuity: Continuity
partial-derivativs: Partial derivatives 
chain-rule: The chain rule
gradient: Directional derivatives and the gradient
tangent-plane: Tangent planes and linear approximation
optimization: Optimization problems
lagrange-multipliers: Lagrange multipliers
double-integrals: Double integrals
integration-in-polar-coordinates: Double integrals in polar coordinates
triple-integrals: Triple integrals
spherical-coordinates: Cylindrical and spherical coordinates
vector-fields: Vector fields
line-integrals: Line integrals
conservative-fields: Conservative vector fields
greens-theorem: Green's theorem
divergence: Divergence
curl: Curl
surface-integral: Surface integrals
stokes-theorem: Stokes' theorem
